..........1...1....................1...1..........
..........1...1....................1...1..........
..111111111...111111111....111111111...111111111..
..1...................1....1...................1..
..1...................1....1...................1..
..1...................1....1...................1..
..1...................1....1...................1..
111...................111111...................111
..................................................
..................................................
..................................................
111...................111111...................111
..1...................1....1...................1..
..1...................1....1...................1..
..1...................1....1...................1..
..1...................1....1...................1..
..111111111...111111111....111111111...111111111..
..........1...1....................1...1..........
..........1...1....................1...1..........
..........1...1....................1...1..........
..........1...1....................1...1..........
..111111111...111111111....111111111...111111111..
..1...................1....1...................1..
..1...................1....1...................1..
..1...................1....1...................1..
..1...................1....1...................1..
111...................111111...................111
..................................................
............P.....................................
..................................................
111...................111111...................111
..1...................1....1...................1..
..1...................1....1...................1..
..1...................1....1...................1..
..1...................1....1...................1..
..111111111...111111111....111111111...111111111..
..........1...1....................1...1..........
..........1...1....................1...1..........
..........1...1....................1...1..........
..........1...1....................1...1..........
..111111111...111111111....111111111...111111111..
..1...................1....1...................1..
..1...................1....1...................1..
..1...................1....1...................1..
..1...................1....1...................1..
111...................111111...................111
..................................................
..................................................
..................................................
111...................111111...................111
..1...................1....1...................1..
..1...................1....1...................1..
..1...................1....1...................1..
..1...................1....1...................1..
..111111111...111111111....111111111...111111111..
..........1...1....................1...1..........
..........1...1....................1...1..........
