11111111111...1111111111111111111111...11111111111
11111111111...1111111111111111111111...11111111111
11111111111...1111111111111111111111...11111111111
111...................111111...................111
111...................111111...................111
111...................111111...................111
111...................111111...................111
111...................111111...................111
..................................................
..................................................
..................................................
111...................111111...................111
111...................111111...................111
111...................111111...................111
111...................111111...................111
111...................111111...................111
111...................111111...................111
11111111111...1111111111111111111111...11111111111
11111111111...1111111111111111111111...11111111111
11111111111...1111111111111111111111...11111111111
11111111111...1111111111111111111111...11111111111
11111111111...1111111111111111111111...11111111111
11111111111...1111111111111111111111...11111111111
111...................111111...................111
111...................111111...................111
111...................111111...................111
111...................111111...................111
111...................111111..........1........111
......................................1...........
............P.........................1...........
......................................1...........
111...................111111..........1........111
111...................111111...................111
111...................111111...................111
111...................111111...................111
111...................111111...................111
11111111111...1111111111111111111111...11111111111
11111111111...1111111111111111111111...11111111111
11111111111...1111111111111111111111...11111111111
11111111111...1111111111111111111111...11111111111
11111111111...1111111111111111111111...11111111111
111...................111111...................111
111...................111111...................111
111...................111111...................111
......................111111......................
.................................................
..................................................
111.......1111111.....111111...................111
111...................111111...................111
111...................111111...................111
111...................111111...................111
111...................111111...................111
11111111111...1111111111111111111111...11111111111
11111111111...1111111111111111111111...11111111111
11111111111...1111111111111111111111...11111111111
